confidential	/,kɔnfi'denʃəl/	a.秘(机)密的;表示信任的;担任机密工作的
confine	/kən'fain,'kɔnfain/	vt.限制;使不外出,禁闭n./pl./界限,范围
confirm	/kən'fə:m/	v.使更坚固,使更坚定;(进一步)证实;确认
conflict	/kən'flikt,'kɔnflikt/	n.战斗,斗争;抵触,冲突v.(with)抵触,冲突
conform	/kən'fɔ:m/	vi.(to)遵守,适应;相似,一致,符合
confront	/kən'frʌnt/	v.使面临,使遭遇;面对(危险等)
confuse	/kən'fju:z/	v.使混乱,混淆
confusion	/kən'fju:ʒən/	n.困惑,糊涂;混淆;混乱,骚乱
congratulate	/kən'ɡrætʃu,leit/	v.(on)祝贺,向…致贺词
congratulation	/kən,ɡrætʃu'leiʃən/	n.(on)祝贺,(pl.)祝贺词
congress	/'kɔŋɡres,kən'ɡres/	n.(代表)大会;(美国等国的)国会,议会
conjunction	/kən'dʒʌŋkʃən/	n.接合,连接,联合;连(接)词
connect	/kə'nekt/	vt.连接;与…联系,接通(电话)vi.连接
connection	/kə'nekʃən/	n.(connexion)联系,连接;亲戚,社会关系
conquer	/'kɔŋkə/	v.征服,战胜,占领;克服,破除(坏习惯等)
conquest	/'kɔŋkwest/	n.征服,征服地,掠取物
conscience	/'kɔnʃəns/	n.良心,良知
conscientious	/,kɔnʃi'enʃəs/	a.审慎正直的,认真的,本着良心的
conscious	/'kɔnʃəs/	a.(of)意识到的,自觉的;神志清醒的
consecutive	/kən'sekjutiv/	a.连续的;连贯的;顺序的
consensus	/kən'sensəs/	n.(意见等的)一致,一致同意,共识
consent	/kən'sent/	v./n.(to)同意,赞成,答应
consequence	/'kɔnsi,kwəns/	n.结果,后果,影响;重要性
consequently	/'kɔnsi,kwəntli/	ad.结果,因此,所以
conservation	/,kɔnsə'veiʃən/	n.保存,保护,保守;守恒,不灭
conservative	/kən'sə:vətiv/	a.保守的,守旧的n.保守主义者
consider	/kən'sidə/	v.考虑,细想;体谅,顾及;认为,把…看作
considerable	/kən'sidərəbl/	a.相当大(或多)的,可观的;值得考虑的
considerate	/kənˈsɪdərət/	a.考虑周到的,体谅的
consideration	/kən,sidə'reiʃən/	n.需要考虑的事,理由;考虑,思考;体谅,照顾
consist	/kən'sist/	v.(in)在于,存在于;(of)由…组成,由…构成
consistent	/kən'sistənt/	a.(in)前后一致的;（with）一致,符合
console	/kən'səul/	n.控制台,仪表板;落地柜vt.安慰,慰问
consolidate	/kən'sɔlideit/	v.使加固,使加强;(把...)联为一体,合并
conspicuous	/kən'spikjuəs/	a.显眼的,明显的
conspiracy	/kən'spirəsi/	n.阴谋,密谋,共谋
constant	/'kɔnstənt/	a.固定的,持续的,忠实的n.常数,恒量
constituent	/kən'stitjuənt/	n.选民;成分,组分a.组成的,构成的
constitute	/'kɔnstitju:t/	vt.组成,构成,形成;设立,建立,任命
constitution	/,kɔnsti'tju:ʃən/	n.构成,构造,组成(方式),成分;体格;宪法
constrain	/kən'strein/	vt.限制,约束;克制,抑制
construct	/kən'strʌkt/	v.建设,建造,构造;创立
construction	/kən'strʌkʃən/	n.建造,构造;建筑物,结构;释义,解释
consult	/kɔn'sʌlt,'kɔnsʌlt/	v.请教,向...咨询,找...商量;查阅,查看
consultant	/kən'sʌltənt/	n.会诊医师,顾问医生;顾问
consume	/kən'sju:m/	vt.消耗;吃完,喝光;(with)使着迷;烧毁
consumption	/kən'sʌmpʃən/	n.消费(量),消耗
contact	/'kɔntækt,kən'tækt/	v./n.(使)接触,联系,交往
contain	/kən'tein/	v.包含,容纳;容忍,抑制;可被...除尽
container	/kən'teinə/	n.容器;集装箱
contaminate	/kən'tæmi,neit/	v.弄污,弄脏,毒害,传染,染污
contemplate	/'kɔntəm,pleit/	vt.盘算,计议;周密考虑;注视,凝视
contemporary	/kən'tempərəri/	a.现代的,当代的;同时代的
contempt	/kən'tempt/	n.轻视,藐视;受辱,丢脸
contend	/kən'tend/	v.竞争,斗争;坚决主张
content	/'kɔntent/	n.容量,内容,(pl.)目录a.(with)满足的
contest	/'kɔntest,kən'test/	n.竞争,竞赛,比赛v.竞争,比赛,争论
context	/'kɔntekst/	n.（文章等）前后关系;(事件等发生的)背景
continent	/'kɔntinənt/	n.大陆,洲
continual	/kən'tinjuəl/	a.不断的,连续的,频繁的
continue	/kən'tinju:/	v.继续,连续,延伸
continuous	/kən'tinjuəs/	a.连续的,持续的
contract	/'kɔntrækt,kən'trækt/	n.(承包)合同/契约v.订合同/契约;使缩小
contradict	/,kɔntrə'dikt/	v.反驳;同…矛盾,同…抵触
contradiction	/,kɔntrə'dikʃən/	n.反驳,否认;矛盾,不一致
contrary	/'kɔntrəri/	a.(to)相反的,矛盾的n.反对,矛盾;相反
contrast	/kən'trɑ:st,-'træst/	n.对比,对照vi.形成对比vt.把…与…对比
contribute	/kən'tribju:t/	v.(to)贡献,捐助,捐献;投稿
contribution	/,kəntri'bju:ʃən/	n.贡献;捐款,捐献物;投稿
contrive	/kən'traiv/	vt.谋划,策划;设法做到;设计,想出
control	/kən'trəul/	n.(over)控制,支配v.控制,支配
controversial	/,kɔntrə'və:ʃəl/	a.引起争论的,有争议的
controversy	/'kɔntrə,və:si/	n.争论,辩论,争吵
convenience	/kən'vi:njəns/	n.便利,方便;(pl.)便利设备
convenient	/kən'vi:njənt/	a.(to)便利的,方便的
convention	/kən'venʃən/	n.大会,会议;惯例,常规,习俗;公约,协定
conventional	/kən'venʃənəl/	a.惯例的,常规的
conversation	/,kɔnvə'seiʃən/	n.会话,谈话
conversely	/ˈkɒnvɜːsli/	ad.相反地
conversion	/kən'və:ʃən/	n.转变,转换;信仰的改变;
convert	/kən'və:t/	v.变换,转换;改变（信仰等）;兑换（钱）
convey	/kən'vei/	v.运送,搬运,转运;传达,传播
convict	/kən'vikt/	v.(经审讯)证明…有罪,宣判…有罪n.囚犯
conviction	/kən'vikʃən/	n.深信,确信;定罪,判罪;
convince	/kən'vins/	v.(of)使信服,使确信
cook	/kuk/	n.厨师v.烹调,烧煮;纂改(账目),捏造
cool	/ku:l/	a.凉的;冷静的n.凉快ad.冷静地v.使变凉
cooperate	/kəu'ɔpəreit/	v.(with)合作,协作,相配合
cooperative	/kəu'ɔpərətiv/	a.合作的,协作的n.合作社
coordinate	/kəu'ɔ:dineit/	a.同等的,并列的;坐标的n.坐标
coordinates	/kəu'ɔ:dineits/	a.同等的n.同等者,坐标vt.协作,协调
cop	/kɒp/	n.警察(slang俚语)
cope	/kəup/	v.(with)竞争,对抗;(with)对付,妥善处理
copper	/'kɔpə/	n.铜;铜币,铜制器
copy	/'kɔpi/	n.抄本,摹本;(一)本vt.抄写;考试中抄袭
copyright	/'kɔpi,rait/	n.／a.版权(的)
cord	/kɔ:d/	n.绳,索
cordial	/'kɔ:djəl/	a.诚恳的,亲切的,热诚的
core	/kɔ:/	n.果核;中心,核心
corn	/kɔ:n/	n.谷物,庄稼,玉米
corner	/'kɔ:nə/	n.角,街角;偏僻处;vt.将…逼入困境;
corporation	/,kɔ:pə'reiʃən/	n.市镇自治机关;法人;公司,企业
correct	/kə'rekt/	a.正确的,恰当的,端正的v.改正,纠正,矫正
correlate	/'kɔ:rə,leit/	n.相互关联的事物v.(with,to)(使)互相关联
correspond	/,kɔ:ri'spɔnd/	v.通信,(with)符合,一致;(to)相当于,对应
correspondence	/,kɔ:ris'pɔndəns/	n.通信,信件;(with)符合;(to)相当于,对应
correspondent	/,kɔ:ri'spɔndənt/	n.记者,通讯员;通信者
corresponding	/,kɔ:ri'spɔndiŋ/	a.符合的,相应的,对应的
corridor	/'kɔridɔ:/	n.走廊,通道
corrode	/kə'rəud/	v.(受)腐蚀,侵蚀
corrupt	/kə'rʌpt/	v.贿赂,收买a.腐败的,贪污的
cosmic	/'kɔzmik/	a.宇宙的;无比巨大的,无穷尽的
cost	/kɔst/	n.成本,费用,代价v.价值为,花费
costly	/'kɔstli/	a.昂贵的,价值高的,豪华的
costume	/'kɔstju:m,kɔ'stju:m/	n.(流行的)服饰;戏装,(特定场合的)套装
cosy	/'kəuzi/	a.暖和舒服的;舒适的/反/uncomfortable
cottage	/'kɔtidʒ/	n.村舍,小屋,别墅
cotton	/'kɔtən/	n.棉花;棉线,棉纱;棉制品
couch	/kautʃ/	n.长沙发;(病人躺的)长榻vt.表达
cough	/kɔ:f/	v./n.咳嗽
could	/强kud,弱kəd/	v.aux.(口语)(表示许可或请求）可以...,行
council	/'kaunsəl/	n.理事会,委员会,议事机构
counsel	/'kaunsəl/	v./n.劝告,忠告n.法律顾问,辩护人
count	/kaunt/	v.数,计算;算入;看作,认为n.计数,总数
counter	/'kauntə/	n.柜台;计数器a./ad.相反(的)v.反对,反击
counterpart	/'kauntə,pɑ:t/	n.对应的人(或物)
country	/'kʌntri/	n.国家;农村,乡下
countryside	/'kʌntri,said/	n.乡下,农村
county	/'kaunti/	n.(英国)郡,(美国)县
couple	/'kʌpl/	n.(一)对,双;夫妇;v.连接,结合
coupon	/'ku:pɔn/	n.证明持券人有某种权利的卡片,票证,赠券
courage	/'kʌridʒ/	n.勇气,胆量
course	/kɔ:s/	n.课程,教程;过程,进程;路程,路线;一道菜
court	/kɔ:t/	n.法院,法庭;宫廷,朝廷;院子;球场
courtesy	/'kə:tisi/	n.谦恭有礼;有礼貌的举止(或言词)
courtyard	/'kɔ:t,jɑ:d/	n.院子,庭院,天井
cousin	/'kʌzən/	n.堂(或表)兄弟,堂(或表)姐妹
cover	/'kʌvə/	v.覆盖,包括,涉及n.盖子,套子;(书的)封面
cow	/kau/	n.母牛,奶牛
coward	/'kauəd/	n.懦夫,胆怯者
crab	/kræb/	n.螃蟹,蟹肉
crack	/kræk/	n.裂纹,缝隙;破裂声v.(使)破裂,砸开
cradle	/'kreidl/	n.摇篮;发源地
craft	/krɑ:ft,kræft/	n.工艺,手艺,技巧;飞机,飞船
crane	/krein/	n.起重机,鹤
crash	/kræʃ/	v./n.碰撞,坠落,摔坏n.失败,瓦解;爆裂声
crawl	/krɔ:l/	v./n.爬行,蠕动;缓慢(的)行进
crazy	/'kreizi/	a.疯狂的,古怪的,蠢的;(about)狂热的
cream	/kri:m/	n.乳脂,(鲜)奶油;奶油色
create	/kri'eit/	v.创造,创作;引起,造成,建立
creative	/kri'eitiv/	a.有创造力的,创造性的
creature	/'kri:tʃə/	n.人,动物;生物
credential	/kri'denʃəl/	n.凭证,(pl.)国书,证明书
credit	/'kredit/	v./n.信用,信任n.信用贷款,赊欠;名誉,名望
creep	/kri:p/	v.爬,爬行;(植物)蔓延
crew	/kru:/	n.全体船员,全体乘务员
cricket	/'krikit/	n.板球;蟋蟀
crime	/kraim/	n.罪行,犯罪
criminal	/'kriminəl/	n.罪犯,刑事犯a.犯罪的,刑事的
cripple	/'kripl/	n.跛子,残疾人v.使跛,使残疾
crisis	/'kraisis/	n.(pl.crises)危机,紧要关头
crisp	/krisp/	a.脆的,易碎的;简明扼要的;（空气）清爽的
criterion	/krai'tiəriən/	n.(pl.criteria或criterions)标准,尺度
critic	/'kritik/	n.批评家,评论家
critical	/'kritikəl/	a.批评的,评论的;危急,紧要的;临界的
criticism	/'kriti,sizəm/	n.评论性的文章,评论;批评,指责,非难
criticize	/'kriti,saiz/	v.(criticise)批评,评论
crop	/krɔp/	n.作物,庄稼;(谷类等的)一熟收成;一批,大量
cross	/krɔ:s/	n.十字(架);苦难a.交叉的;发怒的v.穿过
crown.乌鸦v.	/n.鸡啼,鸣叫
crowd	/kraud/	n.人群;一群,一伙v.聚集,群集;挤满,拥挤
crown	/kraun/	n.王冠,冕;君权,君王v.为…加冕
crucial	/'kru:ʃəl/	a.至关重要的,决定性的
crude	/kru:d/	a.天然的,未加工的;未熟的;粗鲁的,粗野的
cruel	/'kru:əl/	a.残忍的,残酷的
cruise	/kru:z/	v.巡航;以节省燃料的速度前进n.乘船巡游
crush	/krʌʃ/	n./v.压碎,压坏v.压服,压垮
crust	/krʌst/	n.外皮,壳;地壳
cry	/krai/	n.&v.叫,喊,哭;(鸟兽)叫,啼,鸣,嗥
crystal	/'kristəl/	n.水晶,水晶饰品;结晶a.水晶的,透明的
cube	/kju:b/	n.立方形,立方体;立方,三次幂
cucumber	/'kju:kʌmbə/	n.黄瓜
cue	/kju:/	暗示,提示,球杆
cultivate	/'kʌltiveit/	v.耕作,栽培,养殖;培养,教养,磨炼
culture	/'kʌltʃə/	n.文化,文明;修养;耕种;栽培,培育;
cunning	/'kʌniŋ/	a./n.狡猾(的),狡诈(的)
cup	/kʌp/	n.杯子;奖杯,优胜杯;(一)杯,一杯的容量
cupboard	/'kʌbəd/	n.碗柜,小橱
curb	/kə:b/	n.路边,场外证券市场,vt.制止,抑制
cure	/kjuə/	v.(of)治愈,医治;矫正n.治愈,痊愈;良药
curiosity	/,kjuri'ɔsiti/	n.好奇心;古董,古玩
curious	/'kjuəriəs/	a.好奇的,求知的,古怪的,爱挑剔的
curl	/kə:l/	v.(使)卷曲,蜷缩n.卷发;卷曲状;卷曲物
currency	/'kərənsi/	n.流传,流通;通货,货币
current	/'kʌrənt/	n.电流,水流;潮流,趋势a.当前的;流通的
curriculum	/kə'rikjuləm/	n.(pl.curricula)课程,(学校等的)全部课程
curse	/kə:s/	n.诅咒,咒语,祸因vt.诅咒,咒骂,使受罪
curtain	/'kə:tən/	n.窗帘,门帘;幕(布);结束;vt遮掩
curve	/kə:v/	n.曲线,弯曲(物)v.弄弯,成曲形
cushion	/'kuʃən/	n.垫子,软垫vt.装垫子;缓和,减轻;